F 22,28,102
C 255,255,228
NO ./textures/wall.png
SO ./textures/wall.png
WE ./textures/wall.png
EA ./textures/wall.png


        1111111111111111111111111
        1000000000110000000000001
        1011000001110000000000001
        1001000000000000000000001
111111111011000001110000000000001
100000000011000001110101111111111
1011011111111101110000N010001
11110111111111011101010010001
11010000000000011100000010001
10001000000000001100000010001
1000000000000011010100100001
11110001 1110101 101111010001
11111111 1111111 111111111111