SO ./textures/feels_cold_wall.png
WE ./textures/wall.png
NO ./textures/feels_cold_wall.png
EA ./textures/wall.png

F 22,28,102
C 255,255,228

11111111111111111111111111111
11110000001100000000000000001
10110000011100000000000010001
10010000000000000000000010001
10110000011100000000000010001
10000000000000000111011110001
11110111111111011100000010001
11110111111111011101010010001
11000000110101011100000010001
10000000000000001100000010001
10000000000000001100010000001
11000000110101000000000000001
11110111110101000000000000001
10000000001100000100000010001
10000000000000000000000001001
10000000001000010000000001001
10000000001101000000N00000001
10000000000000000001010000001
1111111111111111111111111111