NO ./textures/wall_32.png
SO ./textures/wall_32.png
WE ./textures/wall_32.png
EA ./textures/wall_32.png

F 220,120,25
C 225,30,30

1111111111111111111111111
1000000000000000000001001
1000000000000000000001001
1000000000000000000001001
1000000000000000000000001
1000000000000000000000001
1000000000000000000000001
1000000000000000E00000011
1000000000000000000000001
1111111111111111111111111
