NO ./path_to_the_north_texture.png
SO ./path_to_the_south_texture.png
WE ./path_to_the_west_texture.png
EA ./path_to_the_east_texture.png

F 220,120,25
C 225,30,30

1111111111111111111111111
1000000000000000000001001
1000000000000000000001001
1000000000000000000001001
1000000000000000000000001
1000000000000000000000001
1000000000000000000000001
10000N0000000000000000001
1000000000000000000000001
1111111111111111111111111
