NO ./path_to_the_north_texture.png
SO ./path_to_the_south_texture.png
WE ./path_to_the_west_texture.png
EA ./path_to_the_east_texture.png

F 220,120,25
C 225,30,30

1111111111111111111111111
1000000000110000000000001
1011000001110000000000001
1001000000000000000000001
1111111110110000011100001
1000000000110000011101111
1011011111111101110000001
1111011111111101110101001
1100000011010101110000001
10000E1000000000110000001
1000000000000000110101001
1111111111111111111111111
